49 49 49 49 49 49 49 49 49 49 49 49 49 49 49 49 49 49 49 49 49 49 49 49 49 49 49 49 49 49 49 49 49 49 49 49 49 49 49 49 49 49 49 49 49 49 49 49 49 49
49 49 49 49 49 49 49 49 49 49 49 49 49 49 49 49 49 49 49 49 49 49 49 49 49 49 49 49 49 49 49 49 49 49 49 49 49 49 49 49 49 49 49 49 49 49 49 49 49 49
49 49 49 49 49 49 49 49 49 49 49 49 49 49 49 49 49 49 49 49 49 49 49 49 49 49 49 49 49 49 49 49 49 49 49 49 49 49 49 49 49 49 49 49 49 49 49 49 49 49
49 49 49 49 49 49 49 49 49 49 49 49 49 49 49 49 49 49 49 49 49 49 49 49 49 49 49 49 49 49 49 49 49 49 49 49 49 49 49 49 49 49 49 49 49 49 49 49 49 49
49 49 49 49 49 49 49 49 49 49 49 49 49 49 49 49 49 49 49 49 49 49 49 49 49 49 49 49 49 49 49 49 49 49 49 49 49 49 49 49 49 49 49 49 49 49 49 49 49 49
49 49 49 49 49 49 49 49 49 49 49 49 49 49 49 49 49 49 49 49 49 49 49 49 49 49 49 49 49 49 49 49 49 49 49 49 49 49 49 49 49 49 49 49 49 49 49 49 49 49
49 49 49 49 49 49 49 49 49 49 49 49 49 49 49 49 49 49 49 49 49 49 49 49 49 49 49 49 49 49 49 49 49 49 49 49 49 49 49 49 49 49 49 49 49 49 49 49 49 49
49 49 49 49 49 49 49 49 49 49 49 49 49 49 49 49 49 49 49 49 49 49 49 49 49 49 49 49 49 49 49 49 49 49 49 49 49 49 49 49 49 49 49 49 49 49 49 49 49 49
49 49 49 49 49 49 49 49 49 49 49 49 49 49 49 49 49 49 49 49 49 49 49 49 49 49 49 49 49 49 49 49 49 49 49 49 49 49 49 49 49 49 49 49 49 49 49 49 49 49
49 49 49 49 49 49 49 49 49 49 49 49 49 49 49 49 49 49 49 49 49 49 49 49 49 49 49 49 49 49 49 49 49 49 49 49 49 49 49 49 49 49 49 49 49 49 49 49 49 49
49 49 49 49 49 49 49 49 49 49 49 36 49 49 49 49 49 49 49 49 49 49 49 49 49 49 49 49 49 49 49 49 49 49 49 49 49 49 49 49 49 49 49 49 49 49 49 49 49 49
49 49 49 49 49 49 49 49 49 49 49 32 36 49 49 49 49 49 49 36 49 49 49 49 49 49 49 49 49 49 49 49 36 49 49 49 49 49 49 49 49 49 49 49 49 49 49 49 49 49
49 49 49 49 49 49 49 49 49 49 49 30 36 49 49 49 49 49 36 36 36 36 49 49 49 49 49 49 49 49 49 49 36 36 36 49 49 49 49 49 49 49 49 49 49 49 49 49 49 49
49 49 49 49 49 49 49 49 49 49 36 30 30 49 49 49 49 36 36 30 36 36 36 36 36 49 49 49 49 49 49 49 30 36 36 36 49 49 36 36 36 49 49 49 49 49 49 49 49 49
49 49 49 49 49 49 49 49 49 49 36 30 49 49 49 49 49 36 31 31 30 30 36 36 36 49 49 49 49 49 49 49 30 30 30 36 36 36 36 36 36 49 49 49 49 49 49 49 49 49
49 49 49 49 49 49 49 49 49 36 36 30 36 49 49 49 49 30 49 30 30 30 31 31 49 49 49 49 49 49 36 36 30 30 30 30 36 36 30 30 30 36 49 49 49 49 49 49 49 49
49 49 49 49 49 49 49 49 49 36 36 30 36 49 49 49 49 49 36 30 30 30 30 30 36 49 36 49 49 36 36 36 30 31 31 31 30 30 30 30 30 36 36 49 49 49 49 49 49 49
49 49 49 49 49 49 49 49 36 31 31 31 49 49 49 49 49 36 36 49 30 30 30 49 36 36 36 49 36 36 30 30 30 31 31 31 30 30 30 31 30 30 36 36 49 49 49 49 49 49
49 49 49 49 49 49 49 36 36 30 30 30 36 36 49 49 49 49 30 36 30 30 30 36 31 36 31 36 36 30 30 30 31 31 31 30 30 49 30 30 31 30 30 36 49 49 49 49 49 49
49 49 49 49 49 49 49 36 30 30 31 30 36 36 36 49 49 49 49 36 30 30 30 36 30 31 31 36 31 31 30 31 31 31 31 30 30 36 49 30 31 31 30 30 49 49 49 49 49 49
49 49 49 49 49 49 49 30 49 30 30 31 31 31 36 36 49 36 36 30 30 30 30 30 30 30 30 30 30 30 30 31 31 31 31 30 30 36 36 30 31 31 30 30 49 49 49 49 49 49
49 49 49 49 49 49 49 30 36 30 30 31 30 30 30 36 36 36 30 30 30 31 30 30 30 30 30 30 30 30 30 31 31 31 31 31 30 30 36 49 30 30 49 30 49 49 49 49 49 49
49 49 49 49 49 49 49 49 36 30 30 30 30 30 31 31 36 30 30 30 31 31 30 30 49 30 30 30 30 31 30 30 31 31 31 31 30 30 30 49 49 49 49 49 49 49 49 49 49 49
49 49 49 49 49 49 49 49 30 49 30 30 30 30 30 30 30 30 30 30 30 30 30 30 36 30 30 30 30 31 30 30 30 31 30 30 49 49 49 49 49 49 49 49 49 49 49 49 49 49
49 49 49 49 49 49 49 49 30 36 49 30 30 30 49 30 30 31 31 30 30 30 30 49 36 30 49 30 30 30 30 30 30 30 30 30 36 36 49 49 49 49 49 49 49 49 49 49 49 49
49 49 49 49 49 49 49 49 49 36 36 30 30 30 36 49 30 30 31 30 30 30 49 49 49 49 49 49 30 30 30 30 30 30 30 30 30 30 36 49 49 49 36 49 49 49 49 49 49 49
49 49 49 49 49 49 49 49 36 30 36 30 30 30 36 49 30 30 30 30 30 30 36 49 49 49 49 36 30 30 30 30 30 30 30 30 30 30 36 36 49 36 36 49 49 49 49 49 49 49
49 49 49 49 49 49 49 49 49 49 49 49 30 49 30 49 49 49 30 30 31 31 36 36 36 49 36 30 30 31 30 30 31 31 30 30 30 30 30 36 36 36 30 36 49 49 49 49 49 49
49 49 49 49 49 49 49 49 49 49 49 49 49 49 49 49 49 49 49 49 30 31 30 36 36 36 30 30 31 30 30 30 30 30 30 31 31 31 31 30 36 30 30 36 49 49 49 49 49 49
49 49 49 49 49 49 49 49 49 49 49 49 49 49 49 36 49 49 49 36 30 30 30 30 30 36 49 30 30 30 30 30 30 30 31 31 31 31 31 49 30 30 30 36 49 49 49 49 49 49
49 49 49 49 49 49 49 49 49 49 49 49 49 49 49 36 36 49 49 36 30 30 30 30 30 30 36 30 30 30 30 30 30 30 31 31 31 31 31 36 30 49 49 49 49 49 49 49 49 49
49 49 49 49 49 49 49 49 49 49 49 49 49 49 36 30 36 36 36 30 30 30 31 31 30 30 36 30 30 31 31 30 30 30 31 31 31 31 31 36 30 36 49 49 49 49 49 49 49 49
49 49 49 49 49 49 49 49 49 49 49 49 49 49 36 30 30 36 36 30 31 31 31 31 30 30 30 30 30 30 30 30 30 30 30 31 31 30 30 30 31 30 36 49 49 49 49 49 49 49
49 49 49 49 49 49 49 49 49 49 49 49 49 49 36 31 31 31 31 30 30 49 30 30 30 30 31 30 30 30 30 30 30 49 30 31 30 30 49 49 30 30 30 36 49 49 49 49 49 49
49 49 49 49 49 49 49 49 49 49 49 49 49 49 30 49 49 49 30 30 49 36 30 31 30 30 30 30 30 30 30 30 30 49 30 30 30 49 49 49 30 31 31 36 49 49 49 49 49 49
49 49 49 49 49 49 49 49 49 49 49 49 49 49 49 49 49 49 49 30 36 36 30 31 30 30 30 30 30 30 30 30 30 49 49 30 49 49 49 49 49 30 49 49 49 49 49 49 49 49
49 49 49 49 49 49 49 49 49 49 49 49 49 49 49 49 49 49 49 49 36 30 30 30 30 30 30 30 31 31 49 49 49 49 49 49 49 49 49 49 49 49 49 49 49 49 49 49 49 49
49 49 49 49 49 49 49 49 49 49 49 49 49 49 49 49 49 49 49 49 31 31 31 30 30 30 30 31 31 49 49 49 49 49 49 49 49 49 49 49 49 49 49 49 49 49 49 49 49 49
49 49 49 49 49 49 49 49 49 49 49 49 49 49 49 49 49 49 49 49 49 49 31 31 31 31 31 31 49 49 49 49 49 49 49 49 49 49 49 49 49 49 49 49 49 49 49 49 49 49
49 49 49 49 49 49 49 49 49 49 49 49 49 49 49 49 49 49 49 49 49 49 49 31 49 49 31 49 49 49 49 49 49 49 49 49 49 49 49 49 49 49 49 49 49 49 49 49 49 49
49 49 49 49 49 49 49 49 49 49 49 49 49 49 49 49 49 49 49 49 49 49 49 49 49 49 49 49 49 49 49 49 49 49 49 49 49 49 49 49 49 49 49 49 49 49 49 49 49 49
49 49 49 49 49 49 49 49 49 49 49 49 49 49 49 49 49 49 49 49 49 49 49 49 49 49 49 49 49 49 49 49 49 49 49 49 49 49 49 49 49 49 49 49 49 49 49 49 49 49
49 49 49 49 49 49 49 49 49 49 49 49 49 49 49 49 49 49 49 49 49 49 49 49 49 49 49 49 49 49 49 49 49 49 49 49 49 49 49 49 49 49 49 49 49 49 49 49 49 49
49 49 49 49 49 49 49 49 49 49 49 49 49 49 49 49 49 49 49 49 49 49 49 49 49 49 49 49 49 49 49 49 49 49 49 49 49 49 49 49 49 49 49 49 49 49 49 49 49 49
49 49 49 49 49 49 49 49 49 49 49 49 49 49 49 49 49 49 49 49 49 49 49 49 49 49 49 49 49 49 49 49 49 49 49 49 49 49 49 49 49 49 49 49 49 49 49 49 49 49
49 49 49 49 49 49 49 49 49 49 49 49 49 49 49 49 49 49 49 49 49 49 49 49 49 49 49 49 49 49 49 49 49 49 49 49 49 49 49 49 49 49 49 49 49 49 49 49 49 49
49 49 49 49 49 49 49 49 49 49 49 49 49 49 49 49 49 49 49 49 49 49 49 49 49 49 49 49 49 49 49 49 49 49 49 49 49 49 49 49 49 49 49 49 49 49 49 49 49 49
49 49 49 49 49 49 49 49 49 49 49 49 49 49 49 49 49 49 49 49 49 49 49 49 49 49 49 49 49 49 49 49 49 49 49 49 49 49 49 49 49 49 49 49 49 49 49 49 49 49
49 49 49 49 49 49 49 49 49 49 49 49 49 49 49 49 49 49 49 49 49 49 49 49 49 49 49 49 49 49 49 49 49 49 49 49 49 49 49 49 49 49 49 49 49 49 49 49 49 49
49 49 49 49 49 49 49 49 49 49 49 49 49 49 49 49 49 49 49 49 49 49 49 49 49 49 49 49 49 49 49 49 49 49 49 49 49 49 49 49 49 49 49 49 49 49 49 49 49 49
