5 5 10 8 8 8 8 8 11 5 5 5 5 5 5 5 5 5 5 5 5 5 5 5 5 5 5 5 5 5 5 5 5 5 5 5 5 5 5 5 5 5 5 5 5 5 5 5 5 5 5 5 5 5 5 5 5 5 5 10 8 8 5 5 5 5 5 5 5 5 5 5 5 5 5 5 5 10 8 8 8 8 8 8 8 8 8 11 5 5 5 5 5 5 5 5 5 5 5 5
5 10 9 0 0 0 0 0 4 5 5 5 5 5 5 5 5 5 5 5 5 5 5 5 5 5 5 5 5 5 5 5 5 5 5 5 5 5 5 5 5 5 5 5 5 5 5 5 5 5 5 5 5 5 5 5 5 5 5 6 0 0 7 5 5 5 5 5 5 5 5 5 5 14 5 14 5 6 0 0 15 0 0 0 0 0 0 4 5 5 5 5 5 5 5 5 5 5 5 5
5 6 0 0 0 0 0 0 4 11 5 5 5 5 5 5 5 5 5 5 5 5 5 5 5 5 5 5 5 5 5 5 5 5 5 5 5 5 5 5 5 5 5 5 5 5 5 5 5 5 10 8 8 8 8 8 8 8 8 8 0 0 0 7 8 8 8 8 8 11 10 8 8 11 5 10 8 6 0 0 16 16 15 16 16 0 0 4 11 5 5 5 5 5 5 5 5 5 5 5
5 6 0 0 0 0 0 0 0 4 5 5 5 14 14 5 5 5 5 5 5 5 5 5 5 5 5 5 5 5 5 5 5 5 5 5 5 5 5 5 5 5 5 5 5 5 5 5 10 8 6 0 0 0 0 0 0 0 0 0 0 0 0 0 0 0 0 0 0 4 6 0 0 4 5 6 0 15 0 0 16 16 15 16 16 0 0 0 4 5 5 5 5 5 5 5 5 5 5 5
5 6 0 0 0 0 0 0 4 5 5 5 5 5 14 5 5 5 5 5 5 5 5 5 5 5 5 5 5 5 5 5 5 5 5 5 5 5 5 5 5 5 5 5 5 5 5 5 4 0 6 2 2 3 0 0 0 0 0 0 0 0 0 0 0 0 0 0 0 4 6 0 0 4 5 6 0 15 0 0 16 16 16 16 16 0 0 0 4 5 5 5 5 5 5 5 5 5 5 5
5 12 2 2 2 2 2 2 13 5 5 10 8 8 8 8 8 8 8 8 8 8 8 8 11 5 5 10 8 8 8 8 8 5 5 5 5 5 5 5 5 5 5 5 5 5 5 5 12 2 5 5 5 5 2 3 0 0 0 0 1 2 2 2 3 0 0 0 4 5 6 0 0 4 8 6 0 0 0 0 16 0 15 0 16 0 0 0 4 5 5 5 5 5 5 5 5 5 5 5
5 5 5 5 5 5 14 5 10 8 8 9 17 17 17 17 17 17 17 17 17 17 17 17 7 5 10 9 17 17 17 17 17 4 5 5 5 5 5 5 5 5 5 5 5 5 5 5 5 5 5 5 5 5 5 12 2 2 2 2 13 5 5 5 6 0 0 0 4 5 12 2 2 9 0 4 2 2 3 0 0 0 0 0 0 0 0 0 4 5 5 5 5 5 5 5 5 5 5 5
5 5 5 5 5 5 5 10 9 0 0 30 30 30 30 30 0 23 19 19 19 19 19 19 17 8 9 17 17 17 17 17 17 7 8 5 8 11 5 5 5 5 5 5 5 5 5 5 5 5 5 5 5 5 5 5 5 5 5 5 5 5 5 5 12 2 2 2 13 5 14 5 6 0 1 5 5 10 6 0 0 0 0 15 0 0 0 0 4 5 5 5 5 5 5 5 5 5 5 5
5 5 5 5 5 5 5 6 0 0 30 30 30 30 0 30 0 0 15 15 0 0 16 0 23 19 19 19 19 17 17 17 17 17 17 9 17 7 11 5 5 5 5 5 5 5 5 5 5 5 5 5 5 5 5 5 5 5 5 5 5 5 5 5 5 5 5 5 5 5 14 5 12 2 2 11 5 6 0 0 0 0 0 15 0 0 0 0 4 5 5 5 5 5 5 5 5 5 5 5
5 5 5 5 5 14 5 6 0 0 30 30 30 0 0 0 15 15 15 15 16 16 16 0 0 0 0 0 0 23 0 0 0 23 17 17 17 17 4 14 5 5 5 5 5 5 5 5 5 5 5 5 5 5 5 5 5 5 5 5 5 5 5 5 5 5 5 14 14 14 5 5 5 6 0 8 8 6 0 0 0 15 15 0 0 0 0 0 4 11 5 5 5 5 5 5 5 5 5 5
5 5 5 5 5 5 5 6 0 0 24 30 30 0 15 15 15 15 15 15 0 0 0 0 0 0 0 0 0 0 0 0 0 0 0 17 17 17 4 14 5 5 5 5 5 5 5 5 5 5 5 5 5 5 5 5 5 5 5 5 5 5 5 5 5 5 5 5 10 2 2 2 11 6 0 0 0 0 0 0 0 0 0 0 0 0 0 0 0 4 5 5 5 5 5 5 5 5 5 5
5 5 5 5 5 5 10 6 0 0 21 23 30 30 15 15 15 15 15 15 16 0 0 0 0 0 0 0 0 15 0 0 0 0 15 17 17 17 4 8 11 5 14 5 5 5 5 5 5 5 5 5 5 5 5 5 5 5 5 5 5 5 5 5 5 5 5 5 6 0 16 0 7 6 0 0 3 0 0 0 0 0 0 0 0 0 0 0 0 4 5 5 5 5 5 5 5 5 5 5
5 5 5 5 5 14 6 16 0 22 17 17 23 0 0 0 15 15 15 15 0 0 0 0 0 0 0 0 0 0 0 0 0 0 0 15 17 0 0 0 4 14 14 5 5 5 5 5 5 5 5 5 5 5 5 5 5 5 5 5 5 10 8 11 5 14 5 5 6 0 0 0 0 0 0 0 0 0 0 0 15 0 0 16 16 0 0 0 0 4 5 5 5 5 5 5 5 5 5 5
5 5 5 5 5 5 12 2 2 2 3 17 21 0 0 0 0 0 0 0 0 0 0 0 0 0 0 0 0 0 0 0 0 0 0 16 16 0 0 0 4 5 10 2 2 2 2 2 11 5 5 5 5 5 5 5 5 5 5 5 5 6 0 4 5 5 5 5 6 0 0 3 0 3 0 0 0 0 0 0 15 0 0 16 0 0 0 1 2 11 5 5 5 5 5 5 5 5 5 5
5 5 5 5 5 14 10 8 11 5 6 17 17 17 25 0 0 0 0 0 0 0 0 0 0 0 0 0 0 0 0 0 0 0 0 16 16 0 0 0 4 5 6 0 0 0 0 0 4 5 5 5 5 5 5 5 5 5 5 5 5 6 0 4 5 14 5 10 8 8 8 9 0 0 0 0 0 0 0 0 0 15 0 0 0 1 2 9 0 4 5 5 5 5 5 5 5 5 5 5
5 10 8 11 5 5 6 0 4 8 9 17 17 21 0 0 0 0 0 0 0 0 0 0 0 0 0 15 15 15 0 0 0 17 0 17 17 17 20 0 4 8 6 0 18 20 0 0 4 5 5 5 5 5 5 5 5 5 5 5 5 6 0 4 5 5 14 6 0 0 0 0 0 0 0 0 0 0 0 0 0 15 15 0 0 7 9 0 0 4 5 5 5 5 5 5 5 5 5 5
5 6 0 4 5 5 12 2 6 22 17 17 17 25 0 0 0 16 0 0 0 0 0 0 15 0 15 15 15 15 15 0 23 19 0 17 17 17 21 0 4 0 6 0 23 25 0 1 13 5 5 5 5 5 5 5 5 5 5 5 5 6 0 4 5 5 5 6 0 16 0 0 0 0 0 0 0 0 0 0 0 0 0 0 0 0 0 0 0 4 5 5 5 5 5 5 5 5 5 5
5 12 2 13 8 8 11 10 6 22 17 17 21 0 0 0 16 16 0 0 15 15 0 1 2 2 2 2 3 0 15 0 0 0 0 17 0 17 21 0 4 2 6 0 0 0 0 4 5 5 5 5 5 5 5 5 5 5 5 5 5 12 2 13 5 5 5 6 0 0 0 0 0 0 0 0 15 15 0 0 0 0 0 1 2 2 2 2 2 13 5 5 5 5 5 5 5 5 5 5
5 5 10 9 0 0 4 6 24 19 19 23 21 0 16 0 16 0 0 0 15 1 2 14 5 5 14 10 9 0 15 0 0 15 15 15 0 23 17 0 4 14 12 2 2 2 2 13 5 5 5 5 5 5 5 5 5 5 5 5 5 5 5 5 5 14 5 5 2 3 0 0 0 0 0 0 15 15 15 0 0 0 0 4 5 5 5 5 5 5 5 5 5 5 5 5 5 5 5 5
5 5 6 0 0 1 14 6 0 0 0 0 17 21 16 0 0 0 0 0 0 7 8 8 8 8 5 6 2 2 0 0 0 15 15 15 0 0 17 0 4 10 8 11 5 5 5 5 5 5 5 5 5 5 5 5 5 5 5 5 5 5 5 5 5 5 5 5 9 0 0 0 15 15 0 0 15 15 15 0 0 0 0 4 5 5 5 5 5 5 5 5 5 5 5 5 5 5 5 5
5 5 12 2 2 13 14 6 0 0 0 15 23 25 16 0 0 0 0 0 15 15 15 15 0 15 7 8 8 9 0 0 0 15 0 0 0 0 23 0 4 6 0 4 14 5 5 5 5 5 5 5 5 5 5 5 5 5 5 5 5 5 5 5 14 5 5 6 0 0 0 0 0 0 0 0 15 0 0 0 15 0 0 4 5 5 5 5 5 5 5 5 5 5 5 5 5 5 5 5
5 5 5 5 5 14 5 6 0 0 0 15 15 0 0 0 0 0 0 0 0 18 20 0 0 0 15 15 0 0 0 0 0 0 0 0 0 0 0 0 4 12 2 13 14 5 5 5 5 5 5 5 5 5 5 5 5 5 5 5 5 5 5 5 5 5 8 9 0 0 0 0 0 0 0 0 15 0 15 15 15 0 0 4 5 5 5 5 5 5 5 5 5 5 5 5 5 5 5 5
5 5 5 5 5 5 5 6 0 0 0 0 0 0 0 0 0 0 0 0 0 21 17 20 0 0 0 0 0 0 0 0 0 0 0 0 0 0 0 0 4 5 5 5 14 5 5 14 5 5 5 5 5 5 5 5 5 5 5 5 5 5 5 5 5 9 0 0 0 0 0 0 0 0 0 0 15 15 0 0 0 0 0 4 5 5 5 5 5 5 5 5 5 5 5 5 5 5 5 5
5 5 5 5 5 5 5 6 0 0 0 0 0 0 0 0 0 0 0 0 0 23 19 25 0 0 0 0 0 0 0 0 0 0 0 0 0 0 0 0 7 8 8 8 8 8 8 11 14 5 5 5 5 5 5 5 5 5 5 5 5 5 5 5 9 0 0 0 0 0 0 0 0 0 0 0 15 15 0 0 0 0 0 4 5 5 5 5 5 5 5 5 5 5 5 5 5 5 5 5
5 5 5 5 5 5 5 12 2 3 0 0 0 0 0 18 20 0 0 0 0 0 0 0 0 0 15 15 0 15 0 0 0 0 0 0 0 15 15 0 0 17 21 0 0 0 0 4 5 14 5 5 5 5 5 5 5 5 5 5 5 5 14 6 0 0 0 0 0 0 0 0 0 0 0 0 0 0 0 0 0 0 0 4 5 5 5 5 5 5 5 5 5 5 5 5 5 5 5 5
5 5 5 5 5 5 5 5 5 6 0 0 16 16 0 21 17 20 0 18 20 0 0 0 0 0 15 15 15 15 0 0 0 0 0 0 0 0 15 15 18 17 21 0 15 15 15 7 8 11 5 5 5 14 14 14 5 5 5 5 14 14 5 9 0 0 0 0 0 0 0 15 0 0 0 0 0 0 0 0 0 0 0 4 5 5 5 5 5 5 5 5 5 5 5 5 5 5 5 5
5 5 5 5 5 5 14 5 5 6 0 0 16 16 18 19 19 19 19 19 21 0 0 16 16 0 0 0 0 0 0 0 0 0 17 20 0 0 0 0 17 17 21 0 15 15 0 0 0 7 8 8 8 8 8 8 11 5 14 5 5 8 9 0 0 0 0 0 0 0 15 15 15 0 0 0 0 0 0 0 0 0 0 4 5 5 5 5 5 5 5 5 5 5 5 5 5 5 5 5
5 5 5 5 5 5 5 14 5 12 2 0 0 0 21 1 2 2 2 3 24 20 0 0 16 16 0 0 18 17 20 0 0 0 17 17 0 0 0 0 17 17 17 24 23 0 16 16 0 0 0 0 0 0 0 0 4 5 5 5 9 0 0 0 0 0 0 0 0 15 15 15 0 0 0 0 0 0 0 0 0 0 1 13 5 5 5 5 5 5 5 5 5 5 5 5 5 5 5 5
5 5 5 5 5 5 5 5 14 5 5 3 0 1 2 14 5 5 5 5 3 24 0 0 0 0 0 0 0 17 17 0 0 0 0 0 0 0 0 0 17 17 17 17 17 0 0 16 0 0 0 0 0 0 16 0 7 8 8 9 0 0 0 0 0 0 0 15 15 0 15 0 0 0 0 0 0 0 0 0 0 1 13 5 5 5 5 5 5 5 5 5 5 5 5 5 5 5 5 5
5 5 5 5 5 5 5 5 5 5 5 12 2 5 5 14 5 5 14 10 8 2 3 0 0 0 0 0 0 17 0 0 17 20 0 0 15 15 0 0 23 17 25 0 0 0 0 0 0 0 0 0 0 0 16 0 0 0 0 0 0 0 0 0 0 0 15 0 15 15 0 0 0 0 0 0 0 0 0 1 2 13 5 5 10 8 8 11 5 5 5 5 5 5 5 5 5 5 5 5
5 5 5 5 5 5 5 5 5 5 5 5 5 5 5 5 5 5 14 6 0 0 5 3 0 0 0 0 17 17 17 17 17 17 0 0 15 0 0 0 0 23 0 0 0 0 0 0 0 0 0 0 0 0 0 0 0 0 0 0 0 0 0 0 0 15 0 15 15 0 0 0 0 1 2 2 2 2 2 13 5 5 5 5 6 15 15 7 11 5 5 5 5 5 5 5 5 5 5 5
5 5 5 5 5 5 5 5 5 5 5 5 5 5 5 5 5 5 5 6 0 0 0 5 0 3 6 0 17 17 17 17 17 17 0 0 15 0 0 0 0 0 0 0 0 0 0 0 0 0 0 0 0 0 0 0 0 0 0 0 0 0 0 0 15 15 15 15 0 15 15 0 0 4 5 5 5 5 5 5 5 5 10 8 8 2 3 15 4 5 5 5 5 5 5 5 5 5 5 5
5 5 10 8 8 8 8 8 11 5 5 5 5 5 5 5 5 5 5 12 3 0 18 0 0 6 0 0 0 0 17 17 17 17 0 15 0 0 0 0 0 0 0 0 0 0 0 0 0 0 0 0 0 0 0 0 0 15 0 0 0 0 0 0 15 15 0 0 15 15 0 0 0 4 5 5 5 10 8 8 8 8 9 15 15 7 9 15 4 5 5 5 5 5 5 5 5 5 5 5
5 10 9 0 0 0 0 0 4 5 5 5 5 5 5 5 5 5 5 5 6 0 21 23 0 4 3 0 0 0 17 17 0 0 0 0 0 0 0 0 0 0 0 0 0 0 0 0 0 0 0 0 0 0 0 0 0 0 0 0 0 0 0 0 0 15 0 0 0 0 0 0 0 4 5 5 5 9 15 15 15 15 15 30 0 15 15 1 13 5 5 5 5 5 5 5 5 5 5 5
5 6 0 0 0 0 0 15 4 11 5 5 5 5 5 5 5 5 5 5 6 0 23 25 0 4 5 3 0 2 3 0 0 0 0 0 0 0 0 0 0 0 0 0 0 0 0 0 0 0 0 0 0 0 0 0 0 15 15 15 15 0 0 15 15 15 0 0 0 0 0 0 0 4 5 10 9 15 15 0 0 0 0 0 0 0 15 7 11 5 5 5 5 5 5 5 5 5 5 5
5 6 0 0 15 0 15 15 0 4 5 5 5 5 5 5 5 5 5 5 6 0 0 0 0 4 5 10 2 14 5 2 2 2 3 16 16 16 0 0 0 0 0 0 0 0 0 0 0 16 16 0 0 0 0 0 0 0 0 0 0 0 0 0 0 0 0 0 0 0 0 0 0 4 5 6 15 15 0 0 0 0 0 0 0 0 15 15 4 5 5 5 5 5 5 5 5 5 5 5
5 6 0 0 0 0 0 0 1 5 5 5 5 5 5 5 5 5 5 10 12 5 0 1 2 10 2 6 0 7 8 5 8 8 9 16 1 3 16 16 0 0 0 0 0 16 16 0 0 0 0 0 0 0 0 0 0 0 0 0 0 0 0 0 0 0 0 0 0 0 0 0 0 4 5 6 15 15 0 0 0 0 0 0 0 0 0 15 7 11 5 5 5 5 5 5 5 5 5 5
5 12 2 2 2 2 2 2 13 5 5 10 8 8 8 8 8 8 8 5 0 0 4 5 10 9 0 6 0 15 15 9 16 0 0 16 16 16 16 16 16 16 0 0 0 16 16 16 0 0 0 0 0 0 0 0 0 0 0 0 0 0 0 0 0 0 0 15 15 0 0 0 0 4 8 6 15 15 15 0 0 0 0 0 0 0 0 15 15 4 5 5 5 5 5 5 5 5 5 5
5 5 5 5 5 5 5 5 10 8 8 9 0 15 15 15 15 0 0 0 0 0 7 11 6 0 0 9 0 15 15 0 16 0 0 16 16 0 16 16 16 16 16 0 0 16 16 16 16 16 16 0 0 0 0 0 0 0 0 0 0 0 0 0 15 15 0 0 15 0 0 0 0 7 0 4 10 3 15 15 0 0 0 0 0 0 15 15 15 4 5 5 5 5 5 5 5 5 5 5
5 5 5 5 5 5 5 5 6 0 0 0 0 0 0 0 0 0 0 0 0 0 0 7 8 2 3 0 0 0 16 16 16 16 0 0 0 0 0 0 16 0 16 0 0 0 0 0 0 0 0 0 0 0 0 0 0 0 1 3 0 1 0 0 15 15 15 0 15 0 0 0 0 0 1 13 5 15 3 15 15 15 0 15 15 15 15 1 2 13 5 5 5 5 5 5 5 5 5 5
5 5 10 8 8 8 8 8 11 2 2 2 2 2 2 2 2 2 2 3 0 0 0 0 16 16 16 16 0 0 16 16 16 16 0 0 0 0 0 0 0 0 0 0 0 0 0 0 0 0 0 0 0 0 0 0 0 0 4 12 3 0 0 0 0 0 0 0 15 15 0 0 0 1 5 5 10 2 8 2 2 15 0 15 2 2 2 11 5 5 5 5 5 5 5 5 5 5 5 5
5 10 9 0 0 0 0 0 4 5 5 5 5 5 5 5 5 5 5 12 2 3 0 0 16 16 16 16 0 15 16 16 16 16 16 0 16 0 0 0 0 0 0 0 0 0 0 0 0 0 1 2 2 2 2 2 2 2 5 10 9 0 0 0 0 0 0 0 0 0 0 0 0 5 5 5 6 15 15 15 15 15 0 15 15 15 15 4 5 5 5 5 5 5 5 5 5 5 5 5
5 6 0 0 15 15 0 0 4 11 5 5 5 5 5 5 5 5 5 5 5 6 0 0 15 16 16 16 0 0 15 0 0 0 0 0 16 16 0 0 0 0 0 16 16 0 0 1 2 2 8 8 8 8 8 8 8 8 8 9 0 0 0 2 2 2 2 2 2 2 2 2 2 11 5 10 8 3 15 0 0 0 0 0 0 0 15 4 11 5 5 5 5 5 5 5 5 5 5 5
5 6 0 15 15 15 0 0 0 4 5 5 5 5 5 5 5 5 5 5 10 12 3 0 15 15 0 0 0 0 0 0 0 0 0 0 16 16 16 0 0 0 0 16 16 0 0 4 10 9 0 0 0 0 0 0 0 0 0 0 0 0 0 0 0 0 0 0 0 4 6 0 0 4 5 6 15 15 15 0 0 0 0 0 0 0 15 15 4 5 5 5 5 5 5 5 5 5 5 5
5 6 0 0 0 0 0 0 1 5 5 5 5 5 5 5 5 5 5 10 9 0 0 3 16 0 0 0 0 0 0 0 0 0 0 0 16 0 16 0 16 0 15 0 0 0 0 4 4 0 3 0 0 0 0 0 0 0 0 0 0 0 0 0 0 0 0 0 0 4 6 0 0 4 5 6 15 0 0 0 0 0 0 0 0 0 0 15 4 5 5 5 5 5 5 5 5 5 5 5
5 12 2 2 2 2 2 2 13 5 5 10 8 8 8 8 8 8 8 9 0 8 8 8 8 16 0 0 16 0 16 0 0 16 16 0 16 15 16 16 16 0 15 0 0 1 2 4 12 2 12 2 2 3 0 0 0 0 0 0 0 1 2 2 3 0 0 0 4 13 6 0 0 4 2 6 15 15 15 15 0 0 0 0 0 0 0 15 4 5 5 5 5 5 5 5 5 5 5 5
5 5 5 5 5 5 5 5 10 8 8 9 0 16 0 0 0 0 0 0 15 16 16 0 0 16 0 0 0 16 16 16 16 16 16 0 15 15 16 16 16 16 15 1 2 8 12 13 5 5 5 6 0 0 0 0 16 0 0 0 0 4 5 5 6 0 0 0 4 5 12 2 2 9 0 6 15 15 3 15 0 0 0 0 0 0 0 15 4 5 5 5 5 5 5 5 5 5 5 5
5 5 5 5 5 5 5 5 9 15 0 0 0 16 16 0 0 0 0 0 0 16 16 0 0 0 0 0 0 15 0 16 16 16 0 0 0 0 16 16 16 15 15 4 4 0 4 5 5 5 5 6 16 0 0 0 16 1 2 2 2 13 5 5 12 2 2 2 13 5 5 5 6 0 1 12 2 5 9 15 0 15 15 15 0 0 0 15 4 5 5 5 5 5 5 5 5 5 5 5
5 5 5 5 5 10 8 9 0 0 0 15 15 16 16 0 0 0 0 16 16 16 0 0 15 15 0 0 0 0 0 0 16 16 0 1 0 1 2 2 2 2 2 13 12 2 13 5 5 5 5 6 16 0 0 0 16 4 5 5 5 5 5 5 5 5 5 5 5 5 5 5 12 2 2 5 5 6 15 15 0 15 15 15 15 15 15 15 4 5 5 5 5 5 5 5 5 5 5 5
5 5 5 5 5 6 0 0 0 0 0 0 0 0 0 0 15 0 0 16 0 0 0 0 15 15 0 0 0 0 0 0 0 0 0 0 0 0 4 5 5 5 5 10 8 8 8 8 8 8 9 16 16 0 0 16 16 7 8 8 8 8 11 5 5 5 5 5 5 5 5 5 5 6 15 5 5 6 15 15 15 15 2 2 2 15 15 15 4 11 5 5 5 5 5 5 5 5 5 5
5 5 5 5 5 6 15 0 0 0 0 0 0 0 0 0 15 15 15 0 0 0 0 0 0 15 15 15 15 0 0 16 16 0 0 0 0 0 4 5 5 5 5 6 0 0 0 0 16 16 16 0 0 0 15 16 16 0 16 16 16 0 4 5 5 5 5 5 5 5 5 5 5 6 15 15 15 15 15 3 15 15 4 5 5 3 15 15 15 4 5 5 5 5 5 5 5 5 5 5
5 5 5 5 5 6 0 0 0 3 0 1 2 3 0 0 3 0 15 1 3 0 0 3 0 0 0 16 3 0 3 16 16 0 0 0 0 1 8 8 8 8 8 9 0 15 15 15 15 15 15 15 0 0 0 0 0 0 16 15 15 15 7 8 8 8 8 8 8 11 5 5 5 12 2 2 2 2 2 12 2 2 13 5 5 12 2 2 2 13 5 5 5 5 5 5 5 5 5 5
5 5 5 5 5 12 2 2 2 6 0 0 4 12 2 2 6 0 0 16 16 16 3 0 0 0 0 0 0 16 16 16 16 0 0 0 1 6 0 0 16 0 0 16 16 16 0 15 0 15 0 0 0 15 0 0 15 15 15 15 15 15 15 0 16 16 16 0 0 4 5 5 5 5 5 5 5 5 5 5 5 5 5 5 5 5 5 5 5 5 5 5 5 5 5 5 5 5 5 5
5 5 5 5 5 5 5 5 5 6 0 0 4 5 5 5 6 0 0 3 0 1 5 3 0 0 0 0 1 2 2 2 2 2 2 2 13 6 0 0 16 16 16 0 15 15 15 15 0 15 0 0 0 0 0 0 0 0 0 15 15 15 15 15 15 15 16 16 0 4 5 5 5 5 5 5 5 5 5 5 5 5 5 5 5 5 5 5 5 5 5 5 5 5 5 5 5 5 5 5
5 5 5 5 5 5 5 5 5 6 0 0 4 5 5 5 12 2 2 12 2 5 5 6 0 0 1 2 5 5 5 5 5 5 5 5 5 6 0 15 15 15 15 0 15 15 15 15 15 0 0 0 0 0 0 0 0 0 0 15 15 15 15 15 15 15 0 0 0 4 5 5 5 5 5 5 5 5 5 5 5 5 5 5 5 5 5 5 5 5 5 5 5 5 5 5 5 5 5 5
5 5 5 5 5 5 5 5 5 12 2 2 13 5 5 5 5 5 5 5 5 5 5 12 2 2 13 5 5 5 5 5 5 5 5 5 5 6 0 0 0 0 0 15 15 15 15 15 15 0 0 0 0 0 0 0 0 0 0 0 15 15 15 15 15 15 16 16 16 4 5 5 5 5 5 5 5 5 5 5 5 5 5 5 5 5 5 5 5 5 5 5 5 5 5 5 5 5 5 5
5 5 5 5 5 5 5 5 5 5 5 5 5 5 5 5 5 5 5 5 5 5 5 5 5 5 5 5 5 5 5 5 5 5 5 5 5 6 0 0 16 15 15 15 15 15 15 15 0 0 0 0 0 0 0 0 0 0 0 0 15 15 15 16 0 0 0 0 16 4 5 5 5 5 5 5 5 5 5 5 5 5 5 5 5 5 5 5 5 5 5 5 5 5 5 5 5 5 5 5
5 5 5 5 5 5 5 5 5 5 5 5 5 5 5 5 5 5 5 5 5 5 5 5 5 5 5 5 5 5 5 5 5 5 5 5 5 6 0 0 16 15 15 15 15 15 15 15 0 0 0 0 0 0 0 0 0 0 0 0 15 15 15 16 16 15 15 16 16 4 5 5 5 5 5 5 5 5 5 5 5 5 5 5 5 5 5 5 5 5 5 5 5 5 5 5 5 5 5 5
5 5 5 5 5 5 5 5 5 5 5 5 5 5 5 5 5 5 5 5 5 5 5 5 5 5 5 5 5 5 5 5 5 5 5 5 5 6 0 16 16 15 15 15 15 15 15 15 15 15 15 0 0 0 0 0 0 0 15 15 15 15 15 0 16 15 15 16 0 4 5 5 5 5 5 5 5 5 5 5 5 5 5 5 5 5 5 5 5 5 5 5 5 5 5 5 5 5 5 5
5 5 5 5 5 5 5 5 5 5 5 5 5 5 5 5 5 5 5 5 5 5 5 5 5 5 5 5 5 5 5 5 5 5 5 5 5 6 0 16 16 15 15 15 15 15 15 15 0 0 15 0 0 0 0 0 0 15 15 0 15 15 15 15 0 15 15 16 16 4 5 5 5 5 5 5 5 5 5 5 5 5 5 5 5 5 5 5 5 5 5 5 5 5 5 5 5 5 5 5
5 5 5 5 5 5 5 5 5 5 5 5 5 5 5 5 5 5 5 5 5 5 5 5 5 5 5 5 5 5 5 5 5 5 5 5 5 6 0 16 0 15 15 15 15 16 0 16 0 0 15 0 15 0 0 0 15 15 0 16 16 0 15 15 0 0 16 0 0 4 5 5 5 5 5 5 5 5 5 5 5 5 5 5 5 5 5 5 5 5 5 5 5 5 5 5 5 5 5 5
5 5 5 5 5 5 5 5 5 5 5 5 5 5 5 5 5 5 5 5 5 5 5 5 5 5 5 5 5 5 5 5 5 5 5 5 5 6 0 16 0 16 16 16 16 16 0 0 0 16 16 0 0 0 0 0 0 0 16 16 0 0 15 15 16 16 16 0 0 4 5 5 5 5 5 5 5 5 5 5 5 5 5 5 5 5 5 5 5 5 5 5 5 5 5 5 5 5 5 5
5 5 5 5 5 5 5 5 5 5 5 5 5 5 5 5 5 5 5 5 5 5 5 5 5 5 5 5 5 5 5 5 5 5 5 5 5 6 0 0 16 16 0 0 0 0 0 0 0 0 16 16 16 0 15 15 16 16 0 0 0 16 16 16 0 0 0 0 0 4 5 5 5 5 5 5 5 5 5 5 5 5 5 5 5 5 5 5 5 5 5 5 5 5 5 5 5 5 5 5
5 5 5 5 5 5 5 5 5 5 5 5 5 5 5 5 5 5 5 5 5 5 5 5 5 5 5 5 5 5 5 5 5 5 5 5 5 12 2 2 2 2 2 2 2 2 2 2 2 2 2 3 16 16 0 0 0 1 2 2 2 2 2 2 2 2 2 2 2 13 5 5 5 5 5 5 5 5 5 5 5 5 5 5 5 5 5 5 5 5 5 5 5 5 5 5 5 5 5 5
5 5 5 5 5 5 5 5 5 5 5 5 5 5 5 5 5 5 5 5 5 5 5 5 5 5 5 5 5 5 5 5 5 5 5 5 5 5 5 5 5 5 5 5 5 5 5 5 5 5 5 12 2 2 2 2 2 13 5 5 5 5 5 5 5 5 5 5 5 5 5 5 5 5 5 5 5 5 5 5 5 5 5 5 5 5 5 5 5 5 5 5 5 5 5 5 5 5 5 5
5 5 5 5 5 5 5 5 5 5 5 5 5 5 5 5 5 5 5 5 5 5 5 5 5 5 5 5 5 5 5 5 5 5 5 5 5 5 5 5 5 5 5 5 5 5 5 5 5 5 5 5 5 5 5 5 5 5 5 5 10 8 11 5 5 5 5 5 5 5 5 5 5 5 5 5 5 5 5 5 5 5 5 5 5 5 5 5 5 5 5 5 5 5 5 5 5 5 5 5
5 5 5 5 5 5 5 5 5 5 5 5 5 5 5 5 5 5 5 5 5 5 5 5 5 5 5 5 5 5 5 5 5 5 5 5 5 5 5 5 5 5 5 5 5 5 5 5 5 5 5 5 5 5 5 5 5 5 5 5 6 0 4 5 5 5 5 5 5 5 5 5 5 5 5 5 5 5 5 5 5 5 5 5 5 5 5 5 5 5 5 5 5 5 5 5 5 5 5 5
5 5 5 5 5 5 5 5 5 5 5 5 5 5 5 5 5 5 5 5 5 5 5 5 5 5 5 5 5 5 5 5 5 5 5 5 5 5 5 5 5 5 5 5 5 5 5 5 5 5 5 5 5 5 5 5 5 5 5 5 12 2 13 5 5 5 5 5 5 5 5 5 5 5 5 5 5 5 5 5 5 5 5 5 5 5 5 5 5 5 5 5 5 5 5 5 5 5 5 5
5 5 5 5 5 5 5 5 5 5 5 5 5 5 5 5 5 5 5 5 5 5 5 5 5 5 5 5 5 5 5 5 5 5 5 5 5 5 5 5 5 5 5 5 5 5 5 5 5 5 5 5 5 5 5 5 5 5 5 5 5 5 5 5 5 5 5 5 5 5 5 5 5 5 5 5 5 5 5 5 5 5 5 5 5 5 5 5 5 5 5 5 5 5 5 5 5 5 5 5
5 5 5 5 5 5 5 5 5 5 5 5 5 5 5 5 5 5 5 5 5 5 5 5 5 5 5 5 5 5 5 5 5 5 5 5 5 5 5 5 5 5 5 5 5 5 5 5 5 5 5 5 5 5 5 5 5 5 5 5 5 5 5 5 5 5 5 5 5 5 5 5 5 5 5 5 5 5 5 5 5 5 5 5 5 5 5 5 5 5 5 5 5 5 5 5 5 5 5 5
5 5 5 5 5 5 5 5 5 5 5 5 5 5 5 5 5 5 5 5 5 5 5 5 5 5 5 5 5 5 5 5 5 5 5 5 5 5 5 5 5 5 5 5 5 5 5 5 5 5 5 5 5 5 5 5 5 5 10 8 8 8 8 8 8 8 8 8 8 8 8 8 8 8 8 8 8 8 8 8 8 8 8 8 8 8 8 8 8 8 8 8 8 8 8 8 8 8 11 5
5 5 5 5 5 5 5 5 5 5 5 5 5 5 5 5 5 5 5 5 5 5 5 5 5 5 5 5 5 5 5 5 5 5 5 5 5 5 5 5 5 5 5 5 5 5 5 5 5 5 5 5 5 5 5 5 5 5 6 30 30 30 30 30 30 30 30 30 30 30 30 30 30 30 30 30 30 30 30 30 30 30 30 30 30 30 30 30 30 30 30 30 30 30 30 30 30 30 4 5
5 5 5 5 5 5 5 5 5 5 5 5 5 5 5 5 5 5 5 5 5 5 5 5 5 5 5 5 5 5 5 5 5 5 5 5 5 5 5 5 5 5 5 5 5 5 5 5 5 5 5 5 5 5 5 5 5 5 6 30 30 30 30 30 30 30 30 30 30 30 30 30 30 30 30 30 30 30 30 30 30 30 30 30 30 30 30 30 30 30 30 30 30 30 30 30 30 30 4 5
5 5 5 5 5 5 5 5 5 5 5 5 5 5 5 5 5 5 5 5 5 5 5 5 5 5 5 5 5 5 5 5 5 5 5 5 5 5 5 5 5 5 5 5 5 5 5 5 5 5 5 5 5 5 5 5 5 5 6 30 30 30 30 30 30 30 30 30 30 30 30 30 30 30 30 30 30 30 30 30 30 30 30 30 30 30 30 30 30 30 30 30 30 30 30 30 30 30 4 5
5 5 5 5 5 5 5 5 5 5 5 5 5 5 5 5 5 5 5 5 5 5 5 5 5 5 5 5 5 5 5 5 5 5 5 5 5 5 5 5 5 5 5 5 5 5 5 5 5 5 5 5 5 5 5 5 5 5 6 30 30 30 30 30 30 30 30 30 30 30 30 30 30 30 30 30 30 30 30 30 30 30 30 30 30 30 30 30 30 30 30 30 30 30 30 30 30 30 4 5
5 5 5 5 5 5 5 5 5 5 5 5 5 5 5 5 5 5 5 5 5 5 5 5 5 5 5 5 5 5 5 5 5 5 5 5 5 5 5 5 5 5 5 5 5 5 5 5 5 5 5 5 5 5 5 5 5 5 6 30 30 30 30 30 30 30 30 30 30 30 30 30 30 30 30 30 30 30 30 30 30 30 30 30 30 30 30 30 30 30 30 30 30 30 30 30 30 30 4 5
5 5 5 5 5 5 5 5 5 5 5 5 5 5 5 5 5 5 5 5 5 5 5 5 5 5 5 5 5 5 5 5 5 5 5 5 5 5 5 5 5 5 5 5 5 5 5 5 5 5 5 5 5 5 5 5 5 5 6 30 30 30 30 30 30 30 30 30 30 30 30 30 30 30 30 30 30 30 30 30 30 30 30 30 30 30 30 30 30 30 30 30 30 30 30 30 30 30 4 5
5 5 5 5 5 5 5 5 5 5 5 5 5 5 5 5 5 5 5 5 5 5 5 5 5 5 5 5 5 5 5 5 5 5 5 5 5 5 5 5 5 5 5 5 5 5 5 5 5 5 5 5 5 5 5 5 5 5 6 30 30 30 30 30 30 30 30 30 30 30 30 30 30 30 30 30 30 30 30 30 30 30 30 30 30 30 30 30 30 30 30 30 30 30 30 30 30 30 4 5
5 5 5 5 5 5 5 5 5 5 5 5 5 5 5 5 5 5 5 5 5 5 5 5 5 5 5 5 5 5 5 5 5 5 5 5 5 5 5 5 5 5 5 5 5 5 5 5 5 5 5 5 5 5 5 5 5 5 6 30 30 30 30 30 30 30 30 30 30 30 30 30 30 30 30 30 30 30 30 30 30 30 30 30 30 30 30 30 30 30 30 30 30 30 30 30 30 30 4 5
5 5 5 5 5 5 5 5 5 5 5 5 5 5 5 5 5 5 5 5 5 5 5 5 5 5 5 5 5 5 5 5 5 5 5 5 5 5 5 5 5 5 5 5 5 5 5 5 5 5 5 5 5 5 5 5 5 5 6 30 30 30 30 30 30 30 30 30 30 30 30 30 30 30 30 30 30 30 30 30 30 30 30 30 30 30 30 30 30 30 30 30 30 30 30 30 30 30 4 5
5 5 5 5 5 5 5 5 5 5 5 5 5 5 5 5 5 5 5 5 5 5 5 5 5 5 5 5 5 5 5 5 5 5 5 5 5 5 5 5 5 5 5 5 5 5 5 5 5 5 5 5 5 5 5 5 5 5 6 30 30 30 30 30 30 30 30 30 30 30 30 30 30 30 30 30 30 30 30 30 30 30 30 30 30 30 30 30 30 30 30 30 30 30 30 30 30 30 4 5
5 5 5 5 5 5 5 5 5 5 5 5 5 5 5 5 5 5 5 5 5 5 5 5 5 5 5 5 5 5 5 5 5 5 5 5 5 5 5 5 5 5 5 5 5 5 5 5 5 5 5 5 5 5 5 5 5 5 6 30 30 30 30 30 30 30 30 30 30 30 30 30 30 30 30 30 30 30 30 30 30 30 30 30 30 30 30 30 30 30 30 30 30 30 30 30 30 30 4 5
5 5 5 5 5 5 5 5 5 5 5 5 5 5 5 5 5 5 5 5 5 5 5 5 5 5 5 5 5 5 5 5 5 5 5 5 5 5 5 5 5 5 5 5 5 5 5 5 5 5 5 5 5 5 5 5 5 5 6 30 30 30 30 30 30 30 30 30 30 30 30 30 30 30 30 30 30 30 30 30 30 30 30 30 30 30 30 30 30 30 30 30 30 30 30 30 30 30 4 5
5 5 5 5 5 5 5 5 5 5 5 5 5 5 5 5 5 5 5 5 5 5 5 5 5 5 5 5 5 5 5 5 5 5 5 5 5 5 5 5 5 5 5 5 5 5 5 5 5 5 5 5 5 5 5 5 5 5 6 30 30 30 30 30 30 30 30 30 30 30 30 30 30 30 30 30 30 30 30 30 30 30 30 30 30 30 30 30 30 30 30 30 30 30 30 30 30 30 4 5
5 5 5 5 5 5 5 5 5 5 5 5 5 5 5 5 5 5 5 5 5 5 5 5 5 5 5 5 5 5 5 5 5 5 5 5 5 5 5 5 5 5 5 5 5 5 5 5 5 5 5 5 5 5 5 5 5 5 6 30 30 30 30 30 30 30 30 30 30 30 30 30 30 30 30 30 30 30 30 30 30 30 30 30 30 30 30 30 30 30 30 30 30 30 30 30 30 30 4 5
5 5 5 5 5 5 5 5 5 5 5 5 5 5 5 5 5 5 5 5 5 5 5 5 5 5 5 5 5 5 5 5 5 5 5 5 5 5 5 5 5 5 5 5 5 5 5 5 5 5 5 5 5 5 5 5 5 5 6 30 30 30 30 30 30 30 30 30 30 30 30 30 30 30 30 30 30 30 30 30 30 30 30 30 30 30 30 30 30 30 30 30 30 30 30 30 30 30 4 5
5 5 5 5 5 5 5 5 5 5 5 5 5 5 5 5 5 5 5 5 5 5 5 5 5 5 5 5 5 5 5 5 5 5 5 5 5 5 5 5 5 5 5 5 5 5 5 5 5 5 5 5 5 5 5 5 5 5 6 30 30 30 30 30 30 30 30 30 30 30 30 30 30 30 30 30 30 30 30 30 30 30 30 30 30 30 30 30 30 30 30 30 30 30 30 30 30 30 4 5
5 5 5 5 5 5 5 5 5 5 5 5 5 5 5 5 5 5 5 5 5 5 5 5 5 5 5 5 5 5 5 5 5 5 5 5 5 5 5 5 5 5 5 5 5 5 5 5 5 5 5 5 5 5 5 5 5 5 6 30 30 30 30 30 30 30 30 30 30 30 30 30 30 30 30 30 30 30 30 30 30 30 30 30 30 30 30 30 30 30 30 30 30 30 30 30 30 30 4 5
5 5 5 5 5 5 5 5 5 5 5 5 5 5 5 5 5 5 5 5 5 5 5 5 5 5 5 5 5 5 5 5 5 5 5 5 5 5 5 5 5 5 5 5 5 5 5 5 5 5 5 5 5 5 5 5 5 5 6 30 30 30 30 30 30 30 30 30 30 30 30 30 30 30 30 30 30 30 30 30 30 30 30 30 30 30 30 30 30 30 30 30 30 30 30 30 30 30 4 5
5 5 5 5 5 5 5 5 5 5 5 5 5 5 5 5 5 5 5 5 5 5 5 5 5 5 5 5 5 5 5 5 5 5 5 5 5 5 5 5 5 5 5 5 5 5 5 5 5 5 5 5 5 5 5 5 5 5 6 30 30 30 30 30 30 30 30 30 30 30 30 30 30 30 30 30 30 30 30 30 30 30 30 30 30 30 30 30 30 30 30 30 30 30 30 30 30 30 4 5
5 5 5 5 5 5 5 5 5 5 5 5 5 5 5 5 5 5 5 5 5 5 5 5 5 5 5 5 5 5 5 5 5 5 5 5 5 5 5 5 5 5 5 5 5 5 5 5 5 5 5 5 5 5 5 5 5 5 6 30 30 30 30 30 30 30 30 30 30 30 30 30 30 30 30 30 30 30 30 30 30 30 30 30 30 30 30 30 30 30 30 30 30 30 30 30 30 30 4 5
5 5 5 5 5 5 5 5 5 5 5 5 5 5 5 5 5 5 5 5 5 5 5 5 5 5 5 5 5 5 5 5 5 5 5 5 5 5 5 5 5 5 5 5 5 5 5 5 5 5 5 5 5 5 5 5 5 5 6 30 30 30 30 30 30 30 30 30 30 30 30 30 30 30 30 30 30 30 30 30 30 30 30 30 30 30 30 30 30 30 30 30 30 30 30 30 30 30 4 5
5 5 5 5 5 5 5 5 5 5 5 5 5 5 5 5 5 5 5 5 5 5 5 5 5 5 5 5 5 5 5 5 5 5 5 5 5 5 5 5 5 5 5 5 5 5 5 5 5 5 5 5 5 5 5 5 5 5 6 30 30 30 30 30 30 30 30 30 30 30 30 30 30 30 30 30 30 30 30 30 30 30 30 30 30 30 30 30 30 30 30 30 30 30 30 30 30 30 4 5
5 5 5 5 5 5 5 5 5 5 5 5 5 5 5 5 5 5 5 5 5 5 5 5 5 5 5 5 5 5 5 5 5 5 5 5 5 5 5 5 5 5 5 5 5 5 5 5 5 5 5 5 5 5 5 5 5 5 6 30 30 30 30 30 30 30 30 30 30 30 30 30 30 30 30 30 30 30 30 30 30 30 30 30 30 30 30 30 30 30 30 30 30 30 30 30 30 30 4 5
5 5 5 5 5 5 5 5 5 5 5 5 5 5 5 5 5 5 5 5 5 5 5 5 5 5 5 5 5 5 5 5 5 5 5 5 5 5 5 5 5 5 5 5 5 5 5 5 5 5 5 5 5 5 5 5 5 5 6 30 30 30 30 30 30 30 30 30 30 30 30 30 30 30 30 30 30 30 30 30 30 30 30 30 30 30 30 30 30 30 30 30 30 30 30 30 30 30 4 5
5 5 5 5 5 5 5 5 5 5 5 5 5 5 5 5 5 5 5 5 5 5 5 5 5 5 5 5 5 5 5 5 5 5 5 5 5 5 5 5 5 5 5 5 5 5 5 5 5 5 5 5 5 5 5 5 5 5 6 30 30 30 30 30 30 30 30 30 30 30 30 30 30 30 30 30 30 30 30 30 30 30 30 30 30 30 30 30 30 30 30 30 30 30 30 30 30 30 4 5
5 5 5 5 5 5 5 5 5 5 5 5 5 5 5 5 5 5 5 5 5 5 5 5 5 5 5 5 5 5 5 5 5 5 5 5 5 5 5 5 5 5 5 5 5 5 5 5 5 5 5 5 5 5 5 5 5 5 6 30 30 30 30 30 30 30 30 30 30 30 30 30 30 30 30 30 30 30 30 30 30 30 30 30 30 30 30 30 30 30 30 30 30 30 30 30 30 30 4 5
5 5 5 5 5 5 5 5 5 5 5 5 5 5 5 5 5 5 5 5 5 5 5 5 5 5 5 5 5 5 5 5 5 5 5 5 5 5 5 5 5 5 5 5 5 5 5 5 5 5 5 5 5 5 5 5 5 5 12 2 2 2 2 2 2 2 2 2 2 2 2 2 2 2 2 2 2 2 2 2 2 2 2 2 2 2 2 2 2 2 2 2 2 2 2 2 2 2 13 5
5 5 5 5 5 5 5 5 5 5 5 5 5 5 5 5 5 5 5 5 5 5 5 5 5 5 5 5 5 5 5 5 5 5 5 5 5 5 5 5 5 5 5 5 5 5 5 5 5 5 5 5 5 5 5 5 5 5 5 5 5 5 5 5 5 5 5 5 5 5 5 5 5 5 5 5 5 5 5 5 5 5 5 5 5 5 5 5 5 5 5 5 5 5 5 5 5 5 5 5
5 5 5 5 5 5 5 5 5 5 5 5 5 5 5 5 5 5 5 5 5 5 5 5 5 5 5 5 5 5 5 5 5 5 5 5 5 5 5 5 5 5 5 5 5 5 5 5 5 5 5 5 5 5 5 5 5 5 5 5 5 5 5 5 5 5 5 5 5 5 5 5 5 5 5 5 5 5 5 5 5 5 5 5 5 5 5 5 5 5 5 5 5 5 5 5 5 5 5 5
