49 49 49 49 49 49 49 49 49 49 49 49 49 49 49 49 49 49 49 49 49 49 49 49 49 49 49 49 49 49 49 49 49 49 49 49 49 49 49 49 49 49 49 49 49 49 49 49 49 49
49 49 49 49 49 49 49 49 49 49 49 49 49 49 49 49 49 49 49 49 49 49 49 49 49 35 35 30 30 30 35 49 49 49 49 49 49 49 49 49 49 49 49 49 49 49 49 49 49 49
49 49 49 49 49 49 49 49 49 49 49 49 49 49 49 49 49 49 49 49 49 49 49 49 49 35 35 30 30 30 35 49 49 49 49 49 49 49 49 49 49 49 49 49 49 49 49 49 49 49
49 49 49 49 49 49 49 49 49 49 49 49 49 49 49 49 49 49 49 49 49 49 49 49 49 35 35 30 30 30 35 35 49 49 49 49 49 49 49 49 49 49 49 49 49 49 49 49 49 49
49 49 49 49 49 49 49 49 49 49 49 49 49 49 49 49 49 49 49 49 49 49 49 49 35 49 34 30 30 30 34 35 35 49 49 49 49 49 49 49 49 49 49 49 49 49 49 49 49 49
49 49 49 49 49 49 49 49 49 49 49 49 49 49 49 49 49 49 49 49 49 49 49 49 35 35 31 30 30 30 31 35 35 35 49 49 49 49 49 49 49 49 49 49 49 49 49 49 49 49
49 49 49 49 49 49 49 49 35 35 35 35 35 35 35 35 49 49 49 35 35 35 49 35 35 35 31 30 30 30 31 34 35 35 35 35 35 35 35 35 49 49 35 49 49 49 49 49 49 49
49 49 49 49 49 49 49 49 49 35 49 35 49 35 49 35 49 49 49 35 49 35 35 35 34 35 31 30 30 30 31 31 34 35 35 35 35 35 35 49 35 35 35 35 35 35 35 35 49 49
49 49 49 49 49 49 49 35 35 49 35 35 35 35 35 35 35 49 35 35 35 35 35 49 49 34 31 30 30 30 31 31 31 34 35 35 35 35 35 35 35 35 35 35 35 35 35 49 35 49
49 49 49 49 49 35 35 35 35 35 35 34 35 34 35 49 35 35 35 34 35 34 35 35 35 31 31 30 30 30 31 31 31 31 34 11 11 11 11 35 35 35 34 35 35 35 35 49 49 49
49 49 49 49 49 35 35 35 35 35 35 31 35 31 35 35 35 35 35 49 35 31 34 35 35 31 31 30 30 30 31 31 31 31 31 11 11 11 11 31 34 34 11 11 11 11 34 35 35 49
49 49 49 49 49 35 35 34 34 35 34 31 34 31 34 35 34 35 34 35 34 31 31 35 35 31 31 30 30 30 31 31 31 31 31 11 11 11 11 31 31 31 11 11 11 11 31 35 49 49
49 49 49 49 35 34 34 31 31 11 11 11 11 31 31 35 31 34 31 35 31 31 31 34 34 31 31 30 30 30 31 31 31 31 31 11 11 10 11 31 31 31 11 11 11 11 31 35 49 49
49 49 49 35 35 31 49 31 31 11 11 11 11 31 31 34 31 31 31 35 31 31 31 31 31 31 31 30 30 30 31 31 31 31 31 31 30 30 31 31 31 31 11 11 10 11 31 34 49 49
49 49 49 35 35 31 49 31 31 11 11 11 11 31 31 31 31 31 31 34 31 31 31 31 30 30 30 30 30 30 30 30 30 30 30 31 30 30 31 31 31 31 31 30 30 31 31 31 49 49
49 49 49 35 34 31 35 31 31 11 10 11 11 31 31 31 31 31 31 31 31 31 30 30 30 30 30 30 30 30 30 30 30 30 30 30 30 30 30 30 30 31 31 30 30 31 31 31 49 49
49 49 49 34 31 31 35 31 31 31 30 30 31 31 31 31 31 31 31 30 30 30 30 30 30 31 49 49 49 49 49 49 49 30 30 30 30 30 30 30 30 30 30 30 30 30 30 31 49 49
49 49 49 49 49 31 35 30 30 30 30 30 30 30 30 30 30 30 30 30 30 30 30 31 31 49 49 49 49 49 49 35 35 49 49 49 49 49 49 30 30 30 30 30 30 30 30 31 49 49
49 49 49 35 35 49 34 30 30 30 30 30 30 30 30 30 30 30 30 30 30 30 30 31 31 35 49 49 49 49 49 49 49 49 49 49 49 49 49 49 49 49 49 49 49 49 49 49 49 49
49 49 49 49 49 49 49 49 49 49 49 49 49 49 49 49 49 49 31 31 30 30 30 31 31 35 35 49 49 49 49 49 49 49 49 49 49 49 49 49 49 49 49 49 49 49 49 49 49 49
49 49 49 49 49 49 49 49 49 49 49 49 49 49 49 49 49 35 31 31 30 30 30 31 31 35 35 35 35 49 35 49 49 49 35 35 49 49 35 49 49 49 49 49 49 49 49 49 49 49
49 49 49 49 49 49 49 49 49 49 49 49 49 49 49 35 35 35 31 31 30 30 30 31 31 34 35 35 35 35 35 35 35 35 49 35 35 49 35 35 49 49 49 49 49 49 49 49 49 49
49 49 49 49 49 49 49 49 49 49 49 49 49 35 35 35 35 35 31 31 30 30 30 31 31 31 34 35 35 35 35 35 35 35 35 35 35 35 35 49 35 35 35 35 35 35 49 49 49 49
49 49 49 49 49 49 49 35 35 35 49 35 35 35 35 35 35 34 30 30 30 30 30 30 30 31 31 34 34 35 34 35 35 35 35 34 35 35 34 35 35 35 35 49 35 35 35 35 49 49
49 49 49 49 49 49 35 35 35 35 35 49 49 35 35 34 34 30 30 30 30 30 30 30 30 30 30 31 31 34 31 34 34 34 35 31 34 35 31 35 35 35 35 35 35 35 35 35 35 49
49 49 49 49 49 35 35 35 35 35 49 49 35 49 34 30 30 30 30 30 30 30 30 30 30 30 30 31 31 31 31 31 31 31 34 31 31 34 31 35 34 34 34 35 34 34 35 35 35 49
49 49 49 49 35 35 35 34 34 34 35 49 35 35 31 30 30 30 30 30 31 31 31 30 30 30 30 30 30 30 30 30 30 30 30 30 31 31 31 34 31 31 31 35 31 31 34 34 35 49
49 49 49 49 35 35 34 31 31 31 35 35 35 35 31 30 30 30 30 30 31 31 31 30 30 30 30 30 30 30 30 30 30 30 30 30 30 30 30 30 30 30 31 34 31 31 31 31 34 49
49 49 35 35 35 34 31 31 31 49 35 35 34 35 31 30 30 30 30 30 31 31 31 30 30 30 30 30 30 30 30 30 30 30 30 30 30 30 30 30 30 30 30 30 30 30 30 30 30 49
49 49 35 35 34 31 31 31 31 35 34 35 31 34 49 31 31 30 30 30 30 30 30 30 30 30 31 31 31 31 31 31 30 30 30 30 30 30 30 30 30 30 30 30 30 30 30 30 30 49
49 49 35 35 31 31 31 31 31 35 31 34 31 31 35 31 31 30 30 30 30 30 30 30 30 30 31 31 49 31 31 31 31 31 31 31 31 31 31 31 30 30 30 30 30 30 30 30 30 49
49 35 34 34 31 31 31 31 31 35 31 31 31 31 35 49 31 31 31 31 30 30 30 31 31 31 31 31 35 49 31 31 31 31 31 31 31 31 31 31 31 31 31 31 31 49 49 31 31 49
49 35 31 31 11 11 11 11 31 34 31 31 31 31 34 35 31 49 31 31 30 30 30 31 31 49 49 31 35 35 31 31 31 31 49 31 49 31 31 31 49 31 31 31 31 35 35 49 31 49
49 35 49 31 11 11 11 11 31 31 31 31 31 31 31 35 31 35 31 31 30 30 30 31 31 35 35 31 34 35 31 31 31 31 35 31 35 49 49 49 35 31 31 31 31 35 35 35 31 49
49 34 35 31 11 11 11 11 31 31 31 31 31 31 31 34 31 35 31 31 30 30 30 49 31 35 35 31 31 34 31 31 31 49 49 31 49 49 49 49 49 49 49 49 49 49 49 49 49 49
49 31 35 31 11 11 10 11 31 31 31 31 31 31 31 31 31 34 31 31 30 30 30 35 31 34 34 31 31 31 31 31 31 35 35 49 49 49 49 49 49 49 49 49 49 49 49 49 49 49
49 49 49 31 31 30 30 31 31 31 31 11 11 11 11 31 31 31 31 31 30 30 30 35 31 31 31 11 11 11 11 31 49 35 49 49 49 49 49 49 49 49 49 49 49 49 49 49 49 49
49 49 35 31 31 30 30 31 31 31 31 11 11 11 11 31 31 31 31 31 30 30 30 34 31 31 31 11 11 11 11 31 35 49 49 49 49 49 49 49 49 49 49 49 49 49 49 49 49 49
49 49 35 31 31 30 30 31 31 31 31 11 11 11 11 31 31 31 31 31 30 30 30 31 31 31 31 11 11 11 11 31 35 35 35 49 49 35 49 49 49 49 49 49 49 49 49 49 49 49
49 49 35 31 31 30 30 31 31 31 31 11 11 10 11 31 31 31 31 31 30 30 30 31 31 31 31 11 10 11 11 31 35 35 35 35 35 49 35 49 49 49 49 49 49 49 49 49 49 49
49 49 34 49 31 30 30 30 30 30 30 30 30 30 30 30 30 30 30 30 30 30 30 31 31 31 31 31 30 30 31 31 34 35 35 35 35 35 35 35 35 49 35 49 49 49 49 49 49 49
49 49 31 35 31 31 30 30 30 30 30 30 30 30 30 30 30 30 30 30 30 30 30 31 31 31 31 31 30 30 31 31 31 34 34 35 35 35 35 35 49 35 35 49 49 49 49 49 49 49
49 49 49 49 49 31 49 31 31 31 31 31 31 31 31 31 31 31 31 31 30 30 30 30 30 30 30 30 30 30 30 30 31 31 31 34 34 35 34 35 35 35 49 35 35 35 49 49 49 49
49 49 49 49 49 49 35 31 31 31 31 31 31 31 31 31 31 31 31 31 30 30 30 30 30 30 30 30 30 30 31 31 31 31 31 31 31 34 31 34 35 35 49 49 35 35 49 49 49 49
49 49 49 35 35 35 35 31 31 31 31 31 31 31 31 31 31 31 31 31 30 30 30 31 31 31 31 31 31 31 31 31 31 31 31 31 31 31 31 31 35 34 35 35 35 35 35 49 49 49
49 49 35 35 35 35 35 31 31 31 3 3 3 3 3 3 3 3 3 3 3 3 3 3 3 3 3 3 3 3 3 3 3 3 3 3 31 31 31 31 34 31 35 35 34 34 49 49 35 49
49 49 35 35 35 35 34 31 31 3 3 3 3 3 3 3 3 3 3 3 3 3 3 3 3 3 3 3 3 3 3 3 3 3 3 3 3 3 3 3 3 31 35 35 49 31 35 35 49 49
49 49 35 34 34 34 3 3 3 3 3 3 3 3 3 3 3 3 3 3 3 3 3 3 3 3 3 3 3 3 3 3 3 3 3 3 3 3 3 3 3 3 34 34 35 31 35 35 35 49
49 49 34 31 31 3 3 3 3 3 3 3 3 3 3 3 3 3 3 3 3 3 3 3 3 3 3 3 3 3 3 3 3 3 3 3 3 3 3 3 3 3 3 3 35 31 35 35 35 49
49 49 49 49 49 49 49 49 49 49 49 49 49 49 49 49 49 49 49 49 49 49 49 49 49 49 49 49 49 49 49 49 49 49 49 49 49 49 49 49 49 49 49 49 49 49 49 49 49 49
